0001001000
0000001000
0000100000
0000000000
0000100000
0000001000
0101000000
0000000100
0000100000
0000000000
